WarlordDK	T-U	ClausBy	Skriv besked  Bryd traktat
Watson	--V--	Donoussa	Skriv besked  Bryd traktat
White Dragon	sYv	Alpha	Skriv besked  Bryd traktat
wos	DonoR	palleshave	Skriv besked  Bryd traktat
Wulff	J-K	Deadman Tavern	Skriv besked  Bryd traktat
WuTangClan	WB-P	Vin 3 D	Skriv besked  Bryd traktat
Yugoslavia	-	Za vjeru	Skriv besked  Bryd traktat
Zarina	T-F	zarina	Skriv besked  Bryd traktat
Zu El	--B--	ma 1	Skriv besked  Bryd traktat
φlemming	-	Γ Kapstaden	Skriv besked  Bryd traktat
kikkenborg	UFPR	havneby	Skriv besked  Bryd traktat
kim f p	Bzzz	kfp	Skriv besked  Bryd traktat
Kim Puma  	T-F	Puma K1	Skriv besked  Bryd traktat
King Cassander	LoA	Halkidiki	Skriv besked  Bryd traktat
KING OF DK  	TAR	PIRAT KING VS	Skriv besked  Bryd traktat
King P	--V--	Fusion1	Skriv besked  Bryd traktat
Knubs	T-F	Pølsevognen	Skriv besked  Bryd traktat
kong søren	--V--	PORTER STADT	Skriv besked  Bryd traktat
Kong Triton	-	Valhalla	Skriv besked  Bryd traktat
konge rene 1	--V--	Bagsværd	Skriv besked  Bryd traktat
konge rene 3	--V--	Bagsværd	Skriv besked  Bryd traktat
Kosta Vujic	-	Za istoriju	Skriv besked  Bryd traktat
LarsHansen	SMALL	Polis	Skriv besked  Bryd traktat
Lektor  	TPA	Euklid	Skriv besked  Bryd traktat
Lensgreven	--V--	Brattingsborg	Skriv besked  Bryd traktat
Lilleput	-DS-	Byrum	Skriv besked  Bryd traktat
lin	G_V	Lin Hovedstad	Skriv besked  Bryd traktat
linderod	-	Linderod	Skriv besked  Bryd traktat
Lisette-G	-S-	Blue	Skriv besked  Bryd traktat
Ljubomir S	-	Za vjecnost	Skriv besked  Bryd traktat
Lone	sYv	Divai Mbili	Skriv besked  Bryd traktat
Lora Kael	-MI-	Ossus	Skriv besked  Bryd traktat
Lord Pjuske	DIP	Sin City	Skriv besked  Bryd traktat
Løsgænger  	-HH-	Nanna Smed 1	Skriv besked  Bryd traktat
løven	Guder	Zion	Skriv besked  Bryd traktat
Maden	WB-P	Kilchoman	Skriv besked  Bryd traktat
MadsG  	--V--	Horizon	Skriv besked  Bryd traktat
Malf  	-	V 1	Skriv besked  Bryd traktat
maztercheater	-	Athen	Skriv besked  Bryd traktat
Megalo Afentiko	--V--	Leonton	Skriv besked  Bryd traktat
Megatron	sYv	Jerslev	Skriv besked  Bryd traktat
mgp97	SMALL	V 1	Skriv besked  Bryd traktat
Mika Alas	-	Za Srbiju	Skriv besked  Bryd traktat
mil	-	Miltropolis	Skriv besked  Bryd traktat
Miltbyggeren	IKA_E	By 1	Skriv besked  Bryd traktat
Molly	-	Polis 1	Skriv besked  Bryd traktat
Mopar	IKU	V8village	Skriv besked  Bryd traktat
Mosen	TPA	Dyrup	Skriv besked  Bryd traktat
Mouse xD  	IKA_E	Helms Deep	Skriv besked  Bryd traktat
Mulle	-A-	druk byen	Skriv besked  Bryd traktat
Nanna  	-HH-	Nanna1	Skriv besked  Bryd traktat
nick86	WB-P	vin 1-86 coloss	Skriv besked  Bryd traktat
Nitus_	LoA	Metropolis	Skriv besked  Bryd traktat
NoobSpawn	Wolo	Crash Woah	Skriv besked  Bryd traktat
Nordisk Master	--V--	Give	Skriv besked  Bryd traktat
NoRemus	--V--	Ajax	Skriv besked  Bryd traktat
Nybygger  	ONE	krystal	Skriv besked  Bryd traktat
oledenbarskeond	SMALL	Gilleleje	Skriv besked  Bryd traktat
Orfeus	-TD-	Arresten	Skriv besked  Bryd traktat
Otto delta	-	BPRD	Skriv besked  Bryd traktat
Peter Foged	HoG	Fogedstad	Skriv besked  Bryd traktat
Pirat	-	anton S	Skriv besked  Bryd traktat
PoPPe-	-	Mikkeler	Skriv besked  Bryd traktat
prætorius	F-T	basseby	Skriv besked  Bryd traktat
Quark	Guder	Rock Town	Skriv besked  Bryd traktat
Ralle K	PAVA	Rio de Janeiro	Skriv besked  Bryd traktat
Roadrunner	SMALL	Roadhouse	Skriv besked  Bryd traktat
s-kasperGamma  	-	Marmor1	Skriv besked  Bryd traktat
Salmo trutta	-	iramiun	Skriv besked  Bryd traktat
Sambo	UFPR	Skyshrine	Skriv besked  Bryd traktat
Santino	--B--	Helsingør	Skriv besked  Bryd traktat
Schou	-	Schou1	Skriv besked  Bryd traktat
sevilla	SMALL	Zacatecas	Skriv besked  Bryd traktat
Shine  	-	Shine M	Skriv besked  Bryd traktat
Shorty  	-	Krystal	Skriv besked  Bryd traktat
Silver	-	Sten 1	Skriv besked  Bryd traktat
Sitma	TPA	NR 1	Skriv besked  Bryd traktat
sjakalen	-	Vovhund	Skriv besked  Bryd traktat
skn24	-	Skn 24 Hjem	Skriv besked  Bryd traktat
Skyggen	-	Svovltønden	Skriv besked  Bryd traktat
slambert	-	Humlebyen	Skriv besked  Bryd traktat
SLAMβERT  	-BB-	Vlindrel Hall	Skriv besked  Bryd traktat
smith  	SMALL	sten 1	Skriv besked  Bryd traktat
Smølf	-	SSv1	Skriv besked  Bryd traktat
stiffler	SMALL	Stifflerville	Skriv besked  Bryd traktat
stump666	-	Polis	Skriv besked  Bryd traktat
suntrader	KGB	Onuris S	Skriv besked  Bryd traktat
Supermiks	-	Troja	Skriv besked  Bryd traktat
Svade	--V--	Murupslot	Skriv besked  Bryd traktat
Sven86	-	Svenopolis	Skriv besked  Bryd traktat
Tah Halo	-MI-	Home One	Skriv besked  Bryd traktat
The Phoenix	PhX	Winnix V1	Skriv besked  Bryd traktat
The Ripper	IKA_E	Dead city	Skriv besked  Bryd traktat
TheHacker	TMN	Vin 1	Skriv besked  Bryd traktat
Them	-TR-	T-town 1 -TR-	Skriv besked  Bryd traktat
thobby	-S-	Thobsted70	Skriv besked  Bryd traktat
Tobo2	-	Gilead	Skriv besked  Bryd traktat
Tobotheta	--V--	Mur 44	Skriv besked  Bryd traktat
Tom F P	LoA	Odessa	Skriv besked  Bryd traktat
Topa	WB-P	Topa Svovl Herm	Skriv besked  Bryd traktat
Tower	THH	Armoricum	Skriv besked  Bryd traktat
u2prg  	-	Stronghold 01	Skriv besked  Bryd traktat
Ultima Ratio	SMALL	Vino Uno	Skriv besked  Bryd traktat
ultraviolet	-	Doom valley	Skriv besked  Bryd traktat
vergo71	-GK-	MA1	Skriv besked  Bryd traktat
vfr fan	GTARP	Viffer by	Skriv besked  Bryd traktat
Viking69	-HH-	Krystalby	Skriv besked  Bryd traktat
Vito	WB-P	København	Skriv besked  Bryd traktat
Vuna_	-	HooliganStone	Skriv besked  Bryd traktat
Wanda	-M-	Wandalis	Skriv besked  Bryd traktat
-Diablo-	-	-Diablo-	Skriv besked  Bryd traktat
29kenneth	T-F	Ullerby	Skriv besked  Bryd traktat
3giz	-	Vin 1	Skriv besked  Bryd traktat
Abaddon	-S-	City of Mads	Skriv besked  Bryd traktat
Adamas	F-T	Hellas Mono	Skriv besked  Bryd traktat
Al Neri	--B--	Århus	Skriv besked  Bryd traktat
alfahan	-	Simonacity	Skriv besked  Bryd traktat
Alien7	DUNJE	Mramor1	Skriv besked  Bryd traktat
Andos	A-F	Andonien	Skriv besked  Bryd traktat
anni	--V--	anni 1	Skriv besked  Bryd traktat
Annilis	WB-P	anni 1	Skriv besked  Bryd traktat
Antimachos	-	Alesion	Skriv besked  Bryd traktat
Asbjørn	WB-P	Vinkælderen	Skriv besked  Bryd traktat
badeanden	KGB	Folkvang	Skriv besked  Bryd traktat
balder	-	baldrian	Skriv besked  Bryd traktat
Balski Epsilon	-	Mar 1	Skriv besked  Bryd traktat
Balski eta	HOB	Balski Eta Vin	Skriv besked  Bryd traktat
Beagle	-EGS-	Lijana	Skriv besked  Bryd traktat
Belan	THH	Sanapolis	Skriv besked  Bryd traktat
Binks	T-F	Binks -Mini Man	Skriv besked  Bryd traktat
Black Power	SMALL	Vinis	Skriv besked  Bryd traktat
Blobb	sYv	Ouaga	Skriv besked  Bryd traktat
blobber	-	Husum	Skriv besked  Bryd traktat
BobbyG	ONE	115Timeglasset	Skriv besked  Bryd traktat
Boblebåt	sYv	Femte maj	Skriv besked  Bryd traktat
botter	SMALL	Botter	Skriv besked  Bryd traktat
BreakFree	--V--	BF Vin	Skriv besked  Bryd traktat
Brian1230411	--V--	DEN	Skriv besked  Bryd traktat
Bærmand	F-T	Jordbær	Skriv besked  Bryd traktat
bølleblob	200IQ	Husum	Skriv besked  Bryd traktat
caguje	-	caguje	Skriv besked  Bryd traktat
CAMELONEN	SMALL	STOKMARKNES	Skriv besked  Bryd traktat
chief	T-F	The ChiefsVin	Skriv besked  Bryd traktat
chrdk	-	Doom Town	Skriv besked  Bryd traktat
chrdkenn	-	Vin N1	Skriv besked  Bryd traktat
Clemenza	WB-P	Krystal	Skriv besked  Bryd traktat
Como	Guder	Krystalien	Skriv besked  Bryd traktat
Corellcity	Guder	CorellCity_1	Skriv besked  Bryd traktat
Credit	-	Thermite 1	Skriv besked  Bryd traktat
CSH	SMALL	Svovl D	Skriv besked  Bryd traktat
Daleks	T-U	V 1	Skriv besked  Bryd traktat
darklord	-EGS-	Capitol	Skriv besked  Bryd traktat
deatrix	PhX	Knabstrup	Skriv besked  Bryd traktat
didi2  	THH	Klinteskov	Skriv besked  Bryd traktat
Dobbelt D	-	DD2	Skriv besked  Bryd traktat
Dr braindead	Guder	hvidovre	Skriv besked  Bryd traktat
erlierik	U-T	Wintherby	Skriv besked  Bryd traktat
Falken_	TPA	Dyrup	Skriv besked  Bryd traktat
Feanor	-E-U-	Tirion	Skriv besked  Bryd traktat
Fido  	J-K	Ølfie	Skriv besked  Bryd traktat
Flamse	TPA	Traxex	Skriv besked  Bryd traktat
Ford	--B--	Major	Skriv besked  Bryd traktat
francesco  	-	THE KING	Skriv besked  Bryd traktat
FrankJensen  	-	Viking	Skriv besked  Bryd traktat
fresb	--V--	must	Skriv besked  Bryd traktat
FuglsangAlpha	-	Flying Town	Skriv besked  Bryd traktat
FuglsangBeta	-	Crazy Town	Skriv besked  Bryd traktat
FuglsangDelta	-	Unknown Area	Skriv besked  Bryd traktat
FuglsangEpsilon	-	Sydpolis	Skriv besked  Bryd traktat
FuglsangGamma	-	Burning Bird	Skriv besked  Bryd traktat
FuglsangIota	-	Svendborg	Skriv besked  Bryd traktat
Fætter Højben	F-T	TBR DEN STORE	Skriv besked  Bryd traktat
Galadriel2015  	T-F	Caras Galadhon	Skriv besked  Bryd traktat
Gbastard	--V--	Californien	Skriv besked  Bryd traktat
Gejl	SMALL	Tenal	Skriv besked  Bryd traktat
Golddigger	-	Stenovitz 1	Skriv besked  Bryd traktat
Good55	--B--	Goods City	Skriv besked  Bryd traktat
Grace	-A-	Grace Place	Skriv besked  Bryd traktat
Guggi	THH	Vassingerød	Skriv besked  Bryd traktat
Gutten  	-	Greve	Skriv besked  Bryd traktat
Hefaistos I	SMALL	Incontinentia	Skriv besked  Bryd traktat
Hefaistos II	--B--	Olympen	Skriv besked  Bryd traktat
Hefaistos III	--B--	Olympen	Skriv besked  Bryd traktat
Herodotus	--V--	Athen	Skriv besked  Bryd traktat
Hex	Nomad	Hex gl	Skriv besked  Bryd traktat
Homer	ONE	Herstedøster	Skriv besked  Bryd traktat
Hugoline	TMN	Tappernøje	Skriv besked  Bryd traktat
Hurricane	Guder	Kosta	Skriv besked  Bryd traktat
Hurricane1	Guder	Havdrup	Skriv besked  Bryd traktat
jarjar	F-T	Vita luna	Skriv besked  Bryd traktat
Jasa Prodanovic	-	Za srpsku bracu	Skriv besked  Bryd traktat
JBFO-2	ONE	Måløv	Skriv besked  Bryd traktat
JesloTj	-	MTown	Skriv besked  Bryd traktat
JesperDenStore	TMN	Ra byen	Skriv besked  Bryd traktat
Jetal	THH	Jetal by	Skriv besked  Bryd traktat
jimmie	F-T	Cronner	Skriv besked  Bryd traktat
jna4all	-	Poliss	Skriv besked  Bryd traktat
Joe_slim	-	Graceland	Skriv besked  Bryd traktat
John Nielsen	-	Johnstown	Skriv besked  Bryd traktat
johnjohn159	TAR	Marmor	Skriv besked  Bryd traktat
Joker Legend	--B--	sme	Skriv besked  Bryd traktat
Jovan Cvijic	-	Za krsnu slavu	Skriv besked  Bryd traktat
Juras2	--V--	Godthaab	Skriv besked  Bryd traktat
Juras4	--V--	Godthaab	Skriv besked  Bryd traktat
KaBoom	WB-P	KaBoom K	Skriv besked  Bryd traktat
Kaizer	--B--	Vilamoura 95	Skriv besked  Bryd traktat
Kapetan Dragan	TPA	FN 1	Skriv besked  Bryd traktat
Karpete	SMALL	Krystanlitos I	Skriv besked  Bryd traktat
kenbt	THH	Bodegaen	Skriv besked  Bryd traktat
kiajim  	-A-	kia motors	Skriv besked  Bryd traktat